Name,Total 3P Made,Total 3P Att,Total 3P%,Cold 3P Made,Cold 3P Att,Cold 3P%,Hot 3P Made,Hot 3P Att,Hot 3P%,Hot/Cold Diff,Hot Shot Makeup
carmelo anthony,151,421,35.86698337292161,133,370,35.945945945945944,18,51,35.294117647058826,-0.6518282988871178,12.114014251781473
manny harris,0,2,0,0,2,0,0,0,0,0,0
vince carter,112,296,37.83783783783784,98,264,37.121212121212125,14,32,43.75,6.628787878787875,10.81081081081081
caris levert,59,184,32.065217391304344,55,174,31.60919540229885,4,10,40,8.390804597701148,5.434782608695652
duane ferrell,0,0,0,0,0,0,0,0,0,0,0
ron baker,23,86,26.744186046511626,21,81,25.925925925925924,2,5,40,14.074074074074076,5.813953488372093
darren collison,73,175,41.714285714285715,68,160,42.5,5,15,33.33333333333333,-9.166666666666671,8.571428571428571
ed pinckney,0,0,0,0,0,0,0,0,0,0,0
evan turner,31,118,26.27118644067797,29,113,25.663716814159294,2,5,40,14.336283185840706,4.23728813559322
joe dumars,0,0,0,0,0,0,0,0,0,0,0
lebron james,124,342,36.25730994152047,107,289,37.0242214532872,17,53,32.075471698113205,-4.948749755173992,15.497076023391813
wilson chandler,110,326,33.74233128834356,101,296,34.12162162162162,9,30,30,-4.121621621621621,9.202453987730062
aaron harrison,0,2,0,0,2,0,0,0,0,0,0
david benoit,0,0,0,0,0,0,0,0,0,0,0
deron williams,85,234,36.324786324786324,78,211,36.96682464454976,7,23,30.434782608695656,-6.532042035854104,9.82905982905983
james michael mcadoo,2,8,25,2,6,33.33333333333333,0,2,0,-33.33333333333333,25
pervis ellison,0,0,0,0,0,0,0,0,0,0,0
james harden,262,756,34.65608465608466,225,645,34.883720930232556,37,111,33.33333333333333,-1.5503875968992276,14.682539682539684
luke babbitt,87,210,41.42857142857143,79,192,41.14583333333333,8,18,44.44444444444444,3.2986111111111143,8.571428571428571
mitchell butler,0,0,0,0,0,0,0,0,0,0,0
rodney stuckey,19,60,31.666666666666664,18,59,30.508474576271187,1,1,100,69.49152542372882,1.6666666666666667
boban marjanovic,0,0,0,0,0,0,0,0,0,0,0
danilo gallinari,126,324,38.88888888888889,115,297,38.72053872053872,11,27,40.74074074074074,2.0202020202020208,8.333333333333332
j.j. barea,53,148,35.810810810810814,50,134,37.3134328358209,3,14,21.428571428571427,-15.88486140724947,9.45945945945946
kevin gamble,0,0,0,0,0,0,0,0,0,0,0
pat connaughton,17,33,51.515151515151516,16,31,51.61290322580645,1,2,50,-1.6129032258064484,6.0606060606060606
tyler johnson,93,250,37.2,90,234,38.46153846153847,3,16,18.75,-19.711538461538467,6.4
d'angelo russell,135,384,35.15625,114,319,35.73667711598746,21,65,32.30769230769231,-3.428984808295155,16.927083333333336
ian mahinmi,0,0,0,0,0,0,0,0,0,0,0
jerryd bayless,2,5,40,2,5,40,0,0,0,-40,0
juwan howard,0,0,0,0,0,0,0,0,0,0,0
patricio garino,0,5,0,0,5,0,0,0,0,0,0
bobby phills,0,0,0,0,0,0,0,0,0,0,0
henry ellenson,10,35,28.57142857142857,8,32,25,2,3,66.66666666666666,41.66666666666666,8.571428571428571
khris middleton,45,104,43.269230769230774,42,94,44.680851063829785,3,10,30,-14.680851063829785,9.615384615384617
michael beasley,18,43,41.86046511627907,18,42,42.857142857142854,0,1,0,-42.857142857142854,2.3255813953488373
treveon graham,9,15,60,9,15,60,0,0,0,-60,0
doc rivers,0,0,0,0,0,0,0,0,0,0,0
popeye jones,0,0,0,0,0,0,0,0,0,0,0
bobby portis,32,96,33.33333333333333,30,87,34.48275862068966,2,9,22.22222222222222,-12.260536398467437,9.375
chris whitney,0,0,0,0,0,0,0,0,0,0,0
kelly olynyk,68,192,35.41666666666667,65,180,36.11111111111111,3,12,25,-11.111111111111107,6.25
kyle korver,162,359,45.12534818941504,150,313,47.92332268370607,12,46,26.08695652173913,-21.83636616196694,12.813370473537605
norris cole,3,13,23.076923076923077,3,12,25,0,1,0,-25,7.6923076923076925
otto porter jr.,148,341,43.401759530791786,134,307,43.648208469055376,14,34,41.17647058823529,-2.4717378808200863,9.970674486803519
pascal siakam,1,7,14.285714285714285,1,7,14.285714285714285,0,0,0,-14.285714285714285,0
brandon bass,1,3,33.33333333333333,1,3,33.33333333333333,0,0,0,-33.33333333333333,0
bryn forbes,17,53,32.075471698113205,16,50,32,1,3,33.33333333333333,1.3333333333333286,5.660377358490567
damjan rudez,20,64,31.25,19,62,30.64516129032258,1,2,50,19.35483870967742,3.125
kyle wiltjer,4,13,30.76923076923077,3,12,25,1,1,100,75,7.6923076923076925
lamar patterson,1,6,16.666666666666664,1,6,16.666666666666664,0,0,0,-16.666666666666664,0
mike dunleavy,53,134,39.55223880597015,48,124,38.70967741935484,5,10,50,11.29032258064516,7.462686567164178
rashad vaughn,26,81,32.098765432098766,21,68,30.88235294117647,5,13,38.46153846153847,7.579185520361996,16.049382716049383
tim frazier,40,128,31.25,39,123,31.70731707317073,1,5,20,-11.707317073170731,3.90625
wayne ellington,149,394,37.81725888324873,128,333,38.43843843843844,21,61,34.42622950819672,-4.012208930241719,15.48223350253807
anthony brown,7,27,25.925925925925924,6,25,24,1,2,50,26,7.4074074074074066
darrun hilliard,12,46,26.08695652173913,10,42,23.809523809523807,2,4,50,26.190476190476193,8.695652173913043
greg graham,0,0,0,0,0,0,0,0,0,0,0
jeremy lin,58,156,37.17948717948718,54,140,38.57142857142858,4,16,25,-13.571428571428577,10.256410256410255
joel anthony,0,0,0,0,0,0,0,0,0,0,0
kevon looney,2,9,22.22222222222222,2,9,22.22222222222222,0,0,0,-22.22222222222222,0
taurean prince,33,102,32.35294117647059,32,95,33.68421052631579,1,7,14.285714285714285,-19.398496240601503,6.862745098039216
bismack biyombo,0,0,0,0,0,0,0,0,0,0,0
dell curry,0,0,0,0,0,0,0,0,0,0,0
derrick phelps,0,0,0,0,0,0,0,0,0,0,0
mark bryant,0,0,0,0,0,0,0,0,0,0,0
p.j. brown,0,0,0,0,0,0,0,0,0,0,0
patrick mccaw,41,123,33.33333333333333,37,112,33.035714285714285,4,11,36.36363636363637,3.327922077922082,8.94308943089431
andrew lang,0,0,0,0,0,0,0,0,0,0,0
brandon ingram,55,187,29.411764705882355,52,177,29.37853107344633,3,10,30,0.6214689265536713,5.347593582887701
deandre' bembry,1,18,5.555555555555555,1,18,5.555555555555555,0,0,0,-5.555555555555555,0
jamal mashburn,0,0,0,0,0,0,0,0,0,0,0
karl-anthony towns,101,275,36.72727272727273,96,254,37.79527559055118,5,21,23.809523809523807,-13.985751781027371,7.636363636363637
kelly oubre jr.,54,188,28.723404255319153,51,178,28.651685393258425,3,10,30,1.3483146067415746,5.319148936170213
mindaugas kuzminskas,54,168,32.142857142857146,47,146,32.19178082191781,7,22,31.818181818181817,-0.3735990037359933,13.095238095238097
jeff grayer,0,0,0,0,0,0,0,0,0,0,0
robert covington,137,412,33.25242718446602,121,361,33.51800554016621,16,51,31.372549019607842,-2.1454565205583656,12.37864077669903
anthony tucker,0,0,0,0,0,0,0,0,0,0,0
jayson williams,0,0,0,0,0,0,0,0,0,0,0
jerami grant,43,116,37.06896551724138,42,113,37.16814159292036,1,3,33.33333333333333,-3.834808259587028,2.586206896551724
john lucas iii,0,1,0,0,1,0,0,0,0,0,0
jusuf nurkic,0,1,0,0,1,0,0,0,0,0,0
kosta koufos,0,1,0,0,1,0,0,0,0,0,0
michael smith,0,0,0,0,0,0,0,0,0,0,0
rajon rondo,50,133,37.59398496240601,47,127,37.00787401574803,3,6,50,12.99212598425197,4.511278195488721
stefano rusconi,0,0,0,0,0,0,0,0,0,0,0
anthony tolliver,90,230,39.130434782608695,83,208,39.90384615384615,7,22,31.818181818181817,-8.085664335664337,9.565217391304348
brad lohaus,0,0,0,0,0,0,0,0,0,0,0
damian lillard,214,579,36.96027633851468,180,482,37.344398340248965,34,97,35.051546391752574,-2.2928519484963914,16.753022452504318
domantas sabonis,51,159,32.075471698113205,46,149,30.87248322147651,5,10,50,19.12751677852349,6.289308176100629
georgios papagiannis,0,2,0,0,2,0,0,0,0,0,0
jamie watson,0,0,0,0,0,0,0,0,0,0,0
latrell sprewell,0,0,0,0,0,0,0,0,0,0,0
michael cage,0,0,0,0,0,0,0,0,0,0,0
steven adams,0,1,0,0,1,0,0,0,0,0,0
wesley johnson,29,118,24.576271186440678,27,109,24.770642201834864,2,9,22.22222222222222,-2.5484199796126425,7.627118644067797
yinka dare,0,0,0,0,0,0,0,0,0,0,0
blake griffin,38,113,33.6283185840708,37,109,33.94495412844037,1,4,25,-8.944954128440372,3.5398230088495577
gary payton ii,1,9,11.11111111111111,1,9,11.11111111111111,0,0,0,-11.11111111111111,0
grant hill,0,0,0,0,0,0,0,0,0,0,0
jarell eddie,4,16,25,3,13,23.076923076923077,1,3,33.33333333333333,10.256410256410252,18.75
jason kidd,0,0,0,0,0,0,0,0,0,0,0
mason plumlee,0,6,0,0,6,0,0,0,0,0,0
quinn cook,11,26,42.30769230769231,9,24,37.5,2,2,100,62.5,7.6923076923076925
sean kilpatrick,105,308,34.090909090909086,96,283,33.92226148409894,9,25,36,2.0777385159010606,8.116883116883116
aaron brooks,48,128,37.5,43,117,36.75213675213676,5,11,45.45454545454545,8.702408702408697,8.59375
anthony miller,0,0,0,0,0,0,0,0,0,0,0
dion waiters,85,215,39.53488372093023,76,195,38.97435897435898,9,20,45,6.025641025641022,9.30232558139535
greivis vasquez,1,3,33.33333333333333,1,3,33.33333333333333,0,0,0,-33.33333333333333,0
juan hernangomez,46,113,40.707964601769916,41,101,40.5940594059406,5,12,41.66666666666667,1.0726072607260733,10.619469026548673
matt barnes,87,263,33.07984790874524,79,236,33.47457627118644,8,27,29.629629629629626,-3.8449466415568168,10.26615969581749
scott brooks,0,0,0,0,0,0,0,0,0,0,0
tom gugliotta,0,0,0,0,0,0,0,0,0,0,0
tony snell,144,355,40.563380281690144,131,321,40.809968847352025,13,34,38.23529411764706,-2.5746747297049666,9.577464788732394
troy williams,18,62,29.03225806451613,16,56,28.57142857142857,2,6,33.33333333333333,4.761904761904759,9.67741935483871
alan anderson,14,44,31.818181818181817,13,41,31.70731707317073,1,3,33.33333333333333,1.6260162601625971,6.8181818181818175
david lee,0,0,0,0,0,0,0,0,0,0,0
gary harris,107,255,41.96078431372549,97,226,42.92035398230089,10,29,34.48275862068966,-8.43759536161123,11.372549019607844
jahlil okafor,0,0,0,0,0,0,0,0,0,0,0
jakob poeltl,0,0,0,0,0,0,0,0,0,0,0
jordan hill,0,0,0,0,0,0,0,0,0,0,0
luc longley,0,0,0,0,0,0,0,0,0,0,0
robert parish,0,0,0,0,0,0,0,0,0,0,0
ryan anderson,204,506,40.316205533596836,164,420,39.04761904761905,40,86,46.51162790697674,7.4640088593576905,16.99604743083004
byron scott,0,0,0,0,0,0,0,0,0,0,0
giannis antetokounmpo,49,180,27.22222222222222,47,173,27.167630057803464,2,7,28.57142857142857,1.4037985136251052,3.888888888888889
john henson,0,1,0,0,1,0,0,0,0,0,0
b.j. tyler,0,0,0,0,0,0,0,0,0,0,0
doug west,0,0,0,0,0,0,0,0,0,0,0
frank kaminsky,116,354,32.7683615819209,106,318,33.33333333333333,10,36,27.77777777777778,-5.55555555555555,10.16949152542373
lorenzo williams,0,0,0,0,0,0,0,0,0,0,0
spencer dinwiddie,38,101,37.62376237623762,36,96,37.5,2,5,40,2.5,4.9504950495049505
wesley matthews,174,479,36.32567849686848,161,415,38.795180722891565,13,64,20.3125,-18.482680722891565,13.361169102296449
beno udrih,11,32,34.375,11,32,34.375,0,0,0,-34.375,0
brent price,0,0,0,0,0,0,0,0,0,0,0
jeff hornacek,0,0,0,0,0,0,0,0,0,0,0
marcin gortat,0,2,0,0,2,0,0,0,0,0,0
marvin williams,124,354,35.02824858757062,116,327,35.47400611620795,8,27,29.629629629629626,-5.8443764865783265,7.627118644067797
ramon sessions,21,62,33.87096774193548,20,61,32.78688524590164,1,1,100,67.21311475409837,1.6129032258064515
willie anderson,0,0,0,0,0,0,0,0,0,0,0
billy owens,0,0,0,0,0,0,0,0,0,0,0
boris diaw,20,81,24.691358024691358,18,78,23.076923076923077,2,3,66.66666666666666,43.58974358974358,3.7037037037037033
charlie ward,0,0,0,0,0,0,0,0,0,0,0
paul millsap,75,241,31.12033195020747,71,224,31.69642857142857,4,17,23.52941176470588,-8.167016806722689,7.053941908713693
sherman douglas,0,0,0,0,0,0,0,0,0,0,0
steven smith,0,0,0,0,0,0,0,0,0,0,0
terry rozier,57,179,31.843575418994412,55,170,32.35294117647059,2,9,22.22222222222222,-10.130718954248366,5.027932960893855
eric leckner,0,0,0,0,0,0,0,0,0,0,0
kris humphries,19,54,35.18518518518518,18,53,33.9622641509434,1,1,100,66.0377358490566,1.8518518518518516
langston galloway,120,308,38.961038961038966,104,268,38.80597014925373,16,40,40,1.1940298507462686,12.987012987012985
miles plumlee,0,0,0,0,0,0,0,0,0,0,0
sean elliott,0,0,0,0,0,0,0,0,0,0,0
anthony bonner,0,0,0,0,0,0,0,0,0,0,0
clifford robinson,0,0,0,0,0,0,0,0,0,0,0
eric riley,0,0,0,0,0,0,0,0,0,0,0
robert pack,0,0,0,0,0,0,0,0,0,0,0
stanley johnson,45,154,29.22077922077922,44,146,30.136986301369863,1,8,12.5,-17.636986301369863,5.194805194805195
tomas satoransky,9,37,24.324324324324326,9,37,24.324324324324326,0,0,0,-24.324324324324326,0
ty lawson,34,118,28.8135593220339,33,115,28.695652173913043,1,3,33.33333333333333,4.637681159420286,2.5423728813559325
gary grant,0,0,0,0,0,0,0,0,0,0,0
james young,12,35,34.285714285714285,12,31,38.70967741935484,0,4,0,-38.70967741935484,11.428571428571429
jarrod uthoff,3,9,33.33333333333333,3,9,33.33333333333333,0,0,0,-33.33333333333333,0
joel bolomboy,1,4,25,1,4,25,0,0,0,-25,0
allen crabbe,134,302,44.370860927152314,113,262,43.12977099236641,21,40,52.5,9.37022900763359,13.245033112582782
anthony davis,40,134,29.850746268656714,38,125,30.4,2,9,22.22222222222222,-8.177777777777777,6.7164179104477615
diamond stone,0,0,0,0,0,0,0,0,0,0,0
johnny o'bryant iii,3,6,50,3,6,50,0,0,0,-50,0
jrue holiday,100,281,35.587188612099645,94,262,35.87786259541985,6,19,31.57894736842105,-4.298915226998798,6.761565836298933
vinny del negro,0,0,0,0,0,0,0,0,0,0,0
allan houston,0,0,0,0,0,0,0,0,0,0,0
hollis thompson,32,95,33.68421052631579,30,92,32.608695652173914,2,3,66.66666666666666,34.05797101449274,3.1578947368421053
omri casspi,15,43,34.883720930232556,15,42,35.714285714285715,0,1,0,-35.714285714285715,2.3255813953488373
semaj christon,12,63,19.047619047619047,12,63,19.047619047619047,0,0,0,-19.047619047619047,0
solomon hill,94,270,34.81481481481482,89,254,35.039370078740156,5,16,31.25,-3.7893700787401556,5.9259259259259265
spencer hawes,25,81,30.864197530864196,23,76,30.263157894736842,2,5,40,9.736842105263158,6.172839506172839
george mccloud,0,0,0,0,0,0,0,0,0,0,0
howard eisley,0,0,0,0,0,0,0,0,0,0,0
donatas motiejunas,11,47,23.404255319148938,10,43,23.25581395348837,1,4,25,1.7441860465116292,8.51063829787234
kevin johnson,0,0,0,0,0,0,0,0,0,0,0
lamond murray,0,0,0,0,0,0,0,0,0,0,0
meyers leonard,74,213,34.74178403755869,69,203,33.99014778325123,5,10,50,16.00985221674877,4.694835680751173
reggie jackson,66,184,35.869565217391305,64,178,35.95505617977528,2,6,33.33333333333333,-2.621722846441955,3.260869565217391
brandan wright,0,1,0,0,1,0,0,0,0,0,0
david wesley,0,0,0,0,0,0,0,0,0,0,0
greg monroe,0,4,0,0,4,0,0,0,0,0,0
nick collison,0,1,0,0,1,0,0,0,0,0,0
denzel valentine,73,208,35.09615384615385,63,177,35.59322033898305,10,31,32.25806451612903,-3.33515582285402,14.903846153846153
dragan bender,28,101,27.722772277227726,27,98,27.55102040816326,1,3,33.33333333333333,5.782312925170068,2.9702970297029703
marcus morris,118,357,33.0532212885154,112,334,33.532934131736525,6,23,26.08695652173913,-7.445977609997396,6.442577030812324
patty mills,147,355,41.40845070422535,134,310,43.225806451612904,13,45,28.888888888888886,-14.336917562724018,12.676056338028168
reggie bullock,28,73,38.35616438356164,25,62,40.32258064516129,3,11,27.27272727272727,-13.049853372434018,15.068493150684931
stephen zimmerman,0,0,0,0,0,0,0,0,0,0,0
terrence jones,19,75,25.333333333333336,17,70,24.285714285714285,2,5,40,15.714285714285715,6.666666666666667
tony smith,0,0,0,0,0,0,0,0,0,0,0
andrew bogut,0,1,0,0,1,0,0,0,0,0,0
danny ferry,0,0,0,0,0,0,0,0,0,0,0
david nwaba,1,5,20,1,5,20,0,0,0,-20,0
dino radja,0,0,0,0,0,0,0,0,0,0,0
doug smith,0,0,0,0,0,0,0,0,0,0,0
marcelo huertas,4,19,21.052631578947366,4,18,22.22222222222222,0,1,0,-22.22222222222222,5.263157894736842
trey lyles,65,204,31.862745098039213,58,185,31.351351351351354,7,19,36.84210526315789,5.490753911806536,9.313725490196079
victor oladipo,127,352,36.07954545454545,120,328,36.58536585365854,7,24,29.166666666666668,-7.418699186991869,6.8181818181818175
dee brown,0,0,0,0,0,0,0,0,0,0,0
jon leuer,49,167,29.34131736526946,48,161,29.81366459627329,1,6,16.666666666666664,-13.146997929606627,3.592814371257485
jordan mickey,0,1,0,0,1,0,0,0,0,0,0
kay felder,7,22,31.818181818181817,7,22,31.818181818181817,0,0,0,-31.818181818181817,0
larry nance jr.,10,36,27.77777777777778,10,36,27.77777777777778,0,0,0,-27.77777777777778,0
zach randolph,21,94,22.340425531914892,21,92,22.82608695652174,0,2,0,-22.82608695652174,2.127659574468085
clyde drexler,0,0,0,0,0,0,0,0,0,0,0
dikembe mutombo,0,0,0,0,0,0,0,0,0,0,0
enes kanter,5,38,13.157894736842104,5,38,13.157894736842104,0,0,0,-13.157894736842104,0
greg grant,0,0,0,0,0,0,0,0,0,0,0
marc gasol,104,268,38.80597014925373,95,242,39.25619834710744,9,26,34.61538461538461,-4.6408137317228295,9.701492537313433
metta world peace,9,38,23.684210526315788,6,31,19.35483870967742,3,7,42.857142857142854,23.502304147465434,18.421052631578945
shawn long,7,19,36.84210526315789,7,19,36.84210526315789,0,0,0,-36.84210526315789,0
tony dumas,0,0,0,0,0,0,0,0,0,0,0
bobby brown,14,35,40,11,27,40.74074074074074,3,8,37.5,-3.2407407407407405,22.857142857142858
chris andersen,0,3,0,0,3,0,0,0,0,0,0
damian jones,0,0,0,0,0,0,0,0,0,0,0
jonas valanciunas,1,2,50,1,2,50,0,0,0,-50,0
larry sanders,0,0,0,0,0,0,0,0,0,0,0
mike tobey,0,0,0,0,0,0,0,0,0,0,0
avery bradley,108,277,38.98916967509025,100,252,39.682539682539684,8,25,32,-7.682539682539684,9.025270758122744
elfrid payton,40,146,27.397260273972602,37,140,26.42857142857143,3,6,50,23.57142857142857,4.10958904109589
gorgui dieng,16,43,37.2093023255814,16,42,38.095238095238095,0,1,0,-38.095238095238095,2.3255813953488373
isaiah rider,0,0,0,0,0,0,0,0,0,0,0
john jenkins,1,2,50,1,2,50,0,0,0,-50,0
jonathon simmons,30,102,29.411764705882355,28,98,28.57142857142857,2,4,50,21.42857142857143,3.9215686274509802
josh huestis,2,4,50,2,4,50,0,0,0,-50,0
nikola mirotic,129,377,34.217506631299734,113,325,34.76923076923077,16,52,30.76923076923077,-3.9999999999999964,13.793103448275861
t.j. mcconnell,11,55,20,11,55,20,0,0,0,-20,0
vern fleming,0,0,0,0,0,0,0,0,0,0,0
axel toupane,1,4,25,1,3,33.33333333333333,0,1,0,-33.33333333333333,25
duane causwell,0,0,0,0,0,0,0,0,0,0,0
isaiah whitehead,44,149,29.53020134228188,41,145,28.27586206896552,3,4,75,46.72413793103448,2.684563758389262
joel embiid,36,98,36.734693877551024,33,93,35.483870967741936,3,5,60,24.516129032258064,5.1020408163265305
jordan farmar,4,9,44.44444444444444,4,8,50,0,1,0,-50,11.11111111111111
josh richardson,75,227,33.03964757709251,68,211,32.22748815165877,7,16,43.75,11.522511848341232,7.048458149779736
michael carter-williams,15,64,23.4375,15,64,23.4375,0,0,0,-23.4375,0
ron harper,0,0,0,0,0,0,0,0,0,0,0
tim hardaway jr.,149,417,35.73141486810552,129,369,34.959349593495936,20,48,41.66666666666667,6.707317073170735,11.510791366906476
trey burke,31,70,44.285714285714285,27,64,42.1875,4,6,66.66666666666666,24.479166666666657,8.571428571428571
brian shaw,0,0,0,0,0,0,0,0,0,0,0
carl herrera,0,0,0,0,0,0,0,0,0,0,0
nikola jokic,45,139,32.37410071942446,44,136,32.35294117647059,1,3,33.33333333333333,0.9803921568627416,2.158273381294964
trevor ariza,191,555,34.41441441441441,164,477,34.38155136268344,27,78,34.61538461538461,0.2338332527011744,14.054054054054054
andre drummond,2,7,28.57142857142857,2,7,28.57142857142857,0,0,0,-28.57142857142857,0
antonio lang,0,0,0,0,0,0,0,0,0,0,0
bradley beal,223,552,40.39855072463768,202,478,42.25941422594142,21,74,28.37837837837838,-13.88103584756304,13.405797101449277
buck williams,0,0,0,0,0,0,0,0,0,0,0
doug christie,0,0,0,0,0,0,0,0,0,0,0
kenny anderson,0,0,0,0,0,0,0,0,0,0,0
monta ellis,43,135,31.851851851851855,42,133,31.57894736842105,1,2,50,18.42105263157895,1.4814814814814816
patrick beverley,110,288,38.19444444444444,103,259,39.768339768339764,7,29,24.137931034482758,-15.630408733857006,10.069444444444445
scott burrell,0,0,0,0,0,0,0,0,0,0,0
shawn kemp,0,0,0,0,0,0,0,0,0,0,0
zan tabak,0,0,0,0,0,0,0,0,0,0,0
arron afflalo,62,151,41.05960264900662,59,141,41.843971631205676,3,10,30,-11.843971631205676,6.622516556291391
jeff green,53,193,27.461139896373055,50,181,27.624309392265197,3,12,25,-2.6243093922651965,6.217616580310881
jeff teague,90,252,35.714285714285715,87,244,35.65573770491803,3,8,37.5,1.8442622950819683,3.1746031746031744
pau gasol,56,104,53.84615384615385,54,97,55.670103092783506,2,7,28.57142857142857,-27.098674521354937,6.730769230769231
steve colter,0,0,0,0,0,0,0,0,0,0,0
thon maker,28,74,37.83783783783784,23,63,36.507936507936506,5,11,45.45454545454545,8.946608946608947,14.864864864864865
vincent askew,0,0,0,0,0,0,0,0,0,0,0
alan williams,0,1,0,0,1,0,0,0,0,0,0
charles jones,0,0,0,0,0,0,0,0,0,0,0
derrick rose,13,60,21.666666666666668,13,59,22.033898305084744,0,1,0,-22.033898305084744,1.6666666666666667
deyonta davis,0,0,0,0,0,0,0,0,0,0,0
kevin seraphin,0,2,0,0,2,0,0,0,0,0,0
lucious harris,0,0,0,0,0,0,0,0,0,0,0
buddy hield,148,379,39.050131926121374,131,337,38.87240356083086,17,42,40.476190476190474,1.6037869153596134,11.081794195250659
cameron payne,27,86,31.3953488372093,23,73,31.506849315068493,4,13,30.76923076923077,-0.7376185458377229,15.11627906976744
darrick martin,0,0,0,0,0,0,0,0,0,0,0
felton spencer,0,0,0,0,0,0,0,0,0,0,0
mike conley,171,419,40.81145584725537,155,374,41.44385026737968,16,45,35.55555555555556,-5.888294711824123,10.739856801909307
myles turner,40,116,34.48275862068966,37,109,33.94495412844037,3,7,42.857142857142854,8.912188728702482,6.0344827586206895
vin baker,0,0,0,0,0,0,0,0,0,0,0
willy hernangomez,4,15,26.666666666666668,4,15,26.666666666666668,0,0,0,-26.666666666666668,0
draymond green,81,263,30.798479087452474,73,243,30.04115226337449,8,20,40,9.958847736625511,7.604562737642586
nemanja bjelica,56,177,31.63841807909605,51,167,30.538922155688624,5,10,50,19.461077844311376,5.649717514124294
sam dekker,60,187,32.0855614973262,56,174,32.18390804597701,4,13,30.76923076923077,-1.414677276746243,6.951871657754011
thabo sefolosha,41,120,34.166666666666664,39,116,33.62068965517241,2,4,50,16.379310344827587,3.3333333333333335
thaddeus young,45,118,38.13559322033898,43,109,39.44954128440367,2,9,22.22222222222222,-17.22731906218145,7.627118644067797
wade baldwin iv,3,22,13.636363636363635,3,22,13.636363636363635,0,0,0,-13.636363636363635,0
chris paul,124,302,41.05960264900662,114,269,42.37918215613383,10,33,30.303030303030305,-12.076151853103525,10.927152317880795
dwight howard,0,2,0,0,2,0,0,0,0,0,0
jared dudley,77,203,37.93103448275862,71,189,37.56613756613756,6,14,42.857142857142854,5.291005291005291,6.896551724137931
sam mitchell,0,0,0,0,0,0,0,0,0,0,0
tiago splitter,2,6,33.33333333333333,2,6,33.33333333333333,0,0,0,-33.33333333333333,0
dan schayes,0,0,0,0,0,0,0,0,0,0,0
dwyane wade,45,145,31.03448275862069,41,133,30.82706766917293,4,12,33.33333333333333,2.5062656641603986,8.275862068965518
eric bledsoe,104,310,33.5483870967742,98,286,34.26573426573427,6,24,25,-9.265734265734267,7.741935483870968
hot rod williams,0,0,0,0,0,0,0,0,0,0,0
briante weber,1,10,10,1,10,10,0,0,0,-10,0
jj redick,201,468,42.94871794871795,165,391,42.19948849104859,36,77,46.75324675324675,4.5537582621981585,16.45299145299145
james edwards,0,0,0,0,0,0,0,0,0,0,0
karl malone,0,0,0,0,0,0,0,0,0,0,0
muggsy bogues,0,0,0,0,0,0,0,0,0,0,0
anthony bennett,13,48,27.083333333333332,12,45,26.666666666666668,1,3,33.33333333333333,6.666666666666661,6.25
dante cunningham,71,181,39.226519337016576,67,170,39.411764705882355,4,11,36.36363636363637,-3.048128342245988,6.077348066298343
joe kleine,0,0,0,0,0,0,0,0,0,0,0
manu ginobili,89,227,39.20704845814978,80,198,40.4040404040404,9,29,31.03448275862069,-9.369557645419711,12.77533039647577
marcus smart,94,332,28.313253012048197,82,294,27.89115646258503,12,38,31.57894736842105,3.687790905836021,11.44578313253012
chris mills,0,0,0,0,0,0,0,0,0,0,0
cody zeller,0,1,0,0,1,0,0,0,0,0,0
dennis scott,0,0,0,0,0,0,0,0,0,0,0
isaiah canaan,25,94,26.595744680851062,23,86,26.744186046511626,2,8,25,-1.7441860465116257,8.51063829787234
jeff malone,0,0,0,0,0,0,0,0,0,0,0
jerian grant,49,134,36.56716417910448,48,128,37.5,1,6,16.666666666666664,-20.833333333333336,4.477611940298507
pete chilcutt,0,0,0,0,0,0,0,0,0,0,0
sean rooks,0,0,0,0,0,0,0,0,0,0,0
shelvin mack,37,120,30.833333333333336,36,116,31.03448275862069,1,4,25,-6.03448275862069,3.3333333333333335
willie reed,1,4,25,1,4,25,0,0,0,-25,0
kent bazemore,92,266,34.58646616541353,81,244,33.19672131147541,11,22,50,16.803278688524593,8.270676691729323
markieff morris,71,196,36.224489795918366,68,190,35.78947368421053,3,6,50,14.210526315789473,3.061224489795918
toney douglas,7,42,16.666666666666664,7,41,17.073170731707318,0,1,0,-17.073170731707318,2.380952380952381
demarre carroll,109,320,34.0625,100,284,35.2112676056338,9,36,25,-10.2112676056338,11.25
doug edwards,0,0,0,0,0,0,0,0,0,0,0
jeremy lamb,41,146,28.08219178082192,40,140,28.57142857142857,1,6,16.666666666666664,-11.904761904761905,4.10958904109589
randy foye,67,203,33.004926108374384,61,182,33.51648351648351,6,21,28.57142857142857,-4.945054945054942,10.344827586206897
rondae hollis-jefferson,15,67,22.388059701492537,14,65,21.53846153846154,1,2,50,28.46153846153846,2.9850746268656714
russell westbrook,200,583,34.305317324185246,160,481,33.264033264033266,40,102,39.21568627450981,5.951653010476541,17.495711835334475
benoit benjamin,0,0,0,0,0,0,0,0,0,0,0
chris morris,0,0,0,0,0,0,0,0,0,0,0
david west,3,8,37.5,2,7,28.57142857142857,1,1,100,71.42857142857143,12.5
melvin booker,0,0,0,0,0,0,0,0,0,0,0
timothe luwawu-cabarrot,50,161,31.05590062111801,47,149,31.543624161073826,3,12,25,-6.543624161073826,7.453416149068323
courtney lee,108,269,40.14869888475837,101,251,40.23904382470119,7,18,38.88888888888889,-1.3501549358122986,6.691449814126393
ivica zubac,0,3,0,0,3,0,0,0,0,0,0
mike miller,8,20,40,6,17,35.294117647058826,2,3,66.66666666666666,31.37254901960783,15
antonio davis,0,0,0,0,0,0,0,0,0,0,0
cj wilcox,3,15,20,3,15,20,0,0,0,-20,0
chris dudley,0,0,0,0,0,0,0,0,0,0,0
clint capela,0,0,0,0,0,0,0,0,0,0,0
jared sullinger,3,18,16.666666666666664,3,17,17.647058823529413,0,1,0,-17.647058823529413,5.555555555555555
kendall gill,0,0,0,0,0,0,0,0,0,0,0
lamarcus aldridge,23,56,41.07142857142857,22,55,40,1,1,100,60,1.7857142857142856
stacey king,0,0,0,0,0,0,0,0,0,0,0
avery johnson,0,0,0,0,0,0,0,0,0,0,0
brian grant,0,0,0,0,0,0,0,0,0,0,0
joffrey lauvergne,33,98,33.6734693877551,28,89,31.46067415730337,5,9,55.55555555555556,24.094881398252188,9.183673469387756
archie goodwin,5,15,33.33333333333333,5,15,33.33333333333333,0,0,0,-33.33333333333333,0
greg anthony,0,0,0,0,0,0,0,0,0,0,0
ian clark,61,163,37.423312883435585,56,150,37.333333333333336,5,13,38.46153846153847,1.1282051282051313,7.975460122699387
andy toolson,0,0,0,0,0,0,0,0,0,0,0
harrison barnes,78,222,35.13513513513514,77,213,36.15023474178404,1,9,11.11111111111111,-25.03912363067293,4.054054054054054
jason terry,73,171,42.69005847953216,67,156,42.94871794871795,6,15,40,-2.948717948717949,8.771929824561402
christian laettner,0,0,0,0,0,0,0,0,0,0,0
jordan clarkson,117,356,32.86516853932584,102,319,31.974921630094045,15,37,40.54054054054054,8.565618910446496,10.393258426966293
jose calderon,20,64,31.25,20,62,32.25806451612903,0,2,0,-32.25806451612903,3.125
christian wood,0,5,0,0,5,0,0,0,0,0,0
cory joseph,48,135,35.55555555555556,44,129,34.10852713178294,4,6,66.66666666666666,32.558139534883715,4.444444444444445
demar derozan,33,124,26.61290322580645,31,118,26.27118644067797,2,6,33.33333333333333,7.06214689265536,4.838709677419355
harvey grant,0,0,0,0,0,0,0,0,0,0,0
javale mcgee,0,3,0,0,3,0,0,0,0,0,0
james jones,31,66,46.96969696969697,26,57,45.614035087719294,5,9,55.55555555555556,9.941520467836263,13.636363636363635
nik stauskas,132,359,36.768802228412255,120,326,36.809815950920246,12,33,36.36363636363637,-0.4461795872838792,9.192200557103064
taj gibson,3,13,23.076923076923077,3,13,23.076923076923077,0,0,0,-23.076923076923077,0
bo outlaw,0,0,0,0,0,0,0,0,0,0,0
cristiano felicio,0,0,0,0,0,0,0,0,0,0,0
dorian finney-smith,56,191,29.31937172774869,54,182,29.67032967032967,2,9,22.22222222222222,-7.44810744810745,4.712041884816754
rodney hood,114,307,37.13355048859935,97,261,37.16475095785441,17,46,36.95652173913043,-0.2082292187239787,14.983713355048861
brook lopez,134,387,34.62532299741602,112,324,34.5679012345679,22,63,34.92063492063492,0.35273368606701894,16.27906976744186
jonas jerebko,45,130,34.61538461538461,44,121,36.36363636363637,1,9,11.11111111111111,-25.252525252525256,6.923076923076923
tyler zeller,0,1,0,0,1,0,0,0,0,0,0
doug mcdermott,77,208,37.019230769230774,67,187,35.82887700534759,10,21,47.61904761904761,11.79017061370002,10.096153846153847
nerlens noel,0,1,0,0,1,0,0,0,0,0,0
patrick ewing,0,0,0,0,0,0,0,0,0,0,0
tony parker,23,69,33.33333333333333,22,66,33.33333333333333,1,3,33.33333333333333,0,4.3478260869565215
calbert cheaney,0,0,0,0,0,0,0,0,0,0,0
derek strong,0,0,0,0,0,0,0,0,0,0,0
hassan whiteside,0,0,0,0,0,0,0,0,0,0,0
patrick patterson,94,253,37.15415019762846,85,234,36.324786324786324,9,19,47.368421052631575,11.043634727845252,7.5098814229249005
richard dumas,0,0,0,0,0,0,0,0,0,0,0
tony allen,15,54,27.77777777777778,15,54,27.77777777777778,0,0,0,-27.77777777777778,0
maurice harkless,68,194,35.051546391752574,66,182,36.26373626373626,2,12,16.666666666666664,-19.5970695970696,6.185567010309279
pooh richardson,0,0,0,0,0,0,0,0,0,0,0
seth curry,137,322,42.54658385093168,126,287,43.90243902439025,11,35,31.428571428571427,-12.47386759581882,10.869565217391305
greg sutton,0,0,0,0,0,0,0,0,0,0,0
jr smith,95,271,35.05535055350554,83,228,36.40350877192983,12,43,27.906976744186046,-8.496532027743783,15.867158671586715
justin harper,2,7,28.57142857142857,2,7,28.57142857142857,0,0,0,-28.57142857142857,0
scott skiles,0,0,0,0,0,0,0,0,0,0,0
sedale threatt,0,0,0,0,0,0,0,0,0,0,0
adrian caldwell,0,0,0,0,0,0,0,0,0,0,0
bill wennington,0,0,0,0,0,0,0,0,0,0,0
joe ingles,123,279,44.086021505376344,110,245,44.89795918367347,13,34,38.23529411764706,-6.662665066026413,12.186379928315413
tyson chandler,0,0,0,0,0,0,0,0,0,0,0
charles smith,0,0,0,0,0,0,0,0,0,0,0
e'twaun moore,77,208,37.019230769230774,72,185,38.91891891891892,5,23,21.73913043478261,-17.17978848413631,11.057692307692307
glenn robinson,49,125,39.2,45,113,39.823008849557525,4,12,33.33333333333333,-6.489675516224196,9.6
jon barry,0,0,0,0,0,0,0,0,0,0,0
rudy gay,42,113,37.16814159292036,40,106,37.735849056603776,2,7,28.57142857142857,-9.164420485175206,6.1946902654867255
shaun livingston,1,3,33.33333333333333,1,3,33.33333333333333,0,0,0,-33.33333333333333,0
chinanu onuaku,0,0,0,0,0,0,0,0,0,0,0
dale ellis,0,0,0,0,0,0,0,0,0,0,0
john battle,0,0,0,0,0,0,0,0,0,0,0
mahmoud abdul-rauf,0,0,0,0,0,0,0,0,0,0,0
rik smits,0,0,0,0,0,0,0,0,0,0,0
salah mejri,1,3,33.33333333333333,1,3,33.33333333333333,0,0,0,-33.33333333333333,0
terry porter,0,0,0,0,0,0,0,0,0,0,0
wayne selden,7,28,25,7,27,25.925925925925924,0,1,0,-25.925925925925924,3.571428571428571
corey brewer,27,118,22.88135593220339,26,114,22.807017543859647,1,4,25,2.192982456140353,3.389830508474576
dirk nowitzki,79,209,37.79904306220095,69,188,36.702127659574465,10,21,47.61904761904761,10.916919959473148,10.047846889952153
ersan ilyasova,142,402,35.32338308457712,133,365,36.43835616438356,9,37,24.324324324324326,-12.114031840059237,9.203980099502488
fred roberts,0,0,0,0,0,0,0,0,0,0,0
glenn robinson iii,49,125,39.2,45,113,39.823008849557525,4,12,33.33333333333333,-6.489675516224196,9.6
laphonso ellis,0,0,0,0,0,0,0,0,0,0,0
marquese chriss,72,224,32.142857142857146,66,206,32.038834951456316,6,18,33.33333333333333,1.2944983818770126,8.035714285714286
vlade divac,0,0,0,0,0,0,0,0,0,0,0
dennis rodman,0,0,0,0,0,0,0,0,0,0,0
hubert davis,0,0,0,0,0,0,0,0,0,0,0
tobias harris,109,314,34.71337579617834,104,290,35.86206896551724,5,24,20.833333333333336,-15.028735632183903,7.643312101910828
andrew nicholson,5,27,18.51851851851852,5,27,18.51851851851852,0,0,0,-18.51851851851852,0
danny green,118,311,37.942122186495176,104,279,37.27598566308244,14,32,43.75,6.474014336917563,10.289389067524116
kevin durant,117,312,37.5,104,286,36.36363636363637,13,26,50,13.636363636363633,8.333333333333332
lucas nogueira,3,12,25,3,12,25,0,0,0,-25,0
luis scola,17,50,34,16,48,33.33333333333333,1,2,50,16.66666666666667,4
marcus thornton,28,80,35,25,70,35.714285714285715,3,10,30,-5.714285714285715,12.5
richaun holmes,27,77,35.064935064935064,27,77,35.064935064935064,0,0,0,-35.064935064935064,0
joe harris,85,221,38.46153846153847,75,205,36.58536585365854,10,16,62.5,25.914634146341463,7.239819004524888
monty williams,0,0,0,0,0,0,0,0,0,0,0
pierre jackson,3,11,27.27272727272727,3,11,27.27272727272727,0,0,0,-27.27272727272727,0
adam keefe,0,0,0,0,0,0,0,0,0,0,0
john stockton,0,0,0,0,0,0,0,0,0,0,0
mark jackson,0,0,0,0,0,0,0,0,0,0,0
ricky rubio,60,196,30.612244897959183,55,183,30.05464480874317,5,13,38.46153846153847,8.406893652795297,6.63265306122449
scott williams,0,0,0,0,0,0,0,0,0,0,0
bill curley,0,0,0,0,0,0,0,0,0,0,0
brandon rush,44,114,38.59649122807017,38,107,35.51401869158878,6,7,85.71428571428571,50.20026702269693,6.140350877192982
derrick alston,0,0,0,0,0,0,0,0,0,0,0
eric montross,0,0,0,0,0,0,0,0,0,0,0
joakim noah,0,1,0,0,1,0,0,0,0,0,0
matthew dellavedova,79,215,36.74418604651163,76,200,38,3,15,20,-18,6.976744186046512
robin lopez,0,2,0,0,2,0,0,0,0,0,0
james robinson,0,0,0,0,0,0,0,0,0,0,0
kenny smith,0,0,0,0,0,0,0,0,0,0,0
richard manning,0,0,0,0,0,0,0,0,0,0,0
sam cassell,0,0,0,0,0,0,0,0,0,0,0
steve kerr,0,0,0,0,0,0,0,0,0,0,0
terrell brandon,0,0,0,0,0,0,0,0,0,0,0
danny manning,0,0,0,0,0,0,0,0,0,0,0
gerald green,39,111,35.13513513513514,31,99,31.313131313131315,8,12,66.66666666666666,35.35353535353534,10.81081081081081
johnny newman,0,0,0,0,0,0,0,0,0,0,0
kyle anderson,15,40,37.5,15,38,39.473684210526315,0,2,0,-39.473684210526315,5
nene,3,9,33.33333333333333,3,9,33.33333333333333,0,0,0,-33.33333333333333,0
willie cauley-stein,0,2,0,0,2,0,0,0,0,0,0
austin rivers,111,299,37.12374581939799,96,262,36.6412213740458,15,37,40.54054054054054,3.8993191664947418,12.37458193979933
carlos rogers,0,0,0,0,0,0,0,0,0,0,0
donald royal,0,0,0,0,0,0,0,0,0,0,0
fred vanvleet,11,29,37.93103448275862,10,28,35.714285714285715,1,1,100,64.28571428571428,3.4482758620689653
james ennis iii,51,137,37.22627737226277,49,128,38.28125,2,9,22.22222222222222,-16.05902777777778,6.569343065693431
mike muscala,46,110,41.81818181818181,42,101,41.584158415841586,4,9,44.44444444444444,2.8602860286028573,8.181818181818182
thomas robinson,0,1,0,0,1,0,0,0,0,0,0
tracy murray,0,0,0,0,0,0,0,0,0,0,0
ed davis,0,0,0,0,0,0,0,0,0,0,0
jalen rose,0,0,0,0,0,0,0,0,0,0,0
jaylen brown,46,135,34.074074074074076,44,125,35.199999999999996,2,10,20,-15.199999999999996,7.4074074074074066
kristaps porzingis,112,314,35.6687898089172,102,285,35.78947368421053,10,29,34.48275862068966,-1.306715063520869,9.235668789808917
trevor booker,25,78,32.05128205128205,25,77,32.467532467532465,0,1,0,-32.467532467532465,1.282051282051282
bison dele,0,0,0,0,0,0,0,0,0,0,0
brian roberts,17,44,38.63636363636363,13,38,34.21052631578947,4,6,66.66666666666666,32.456140350877185,13.636363636363635
chris mccullough,1,7,14.285714285714285,1,7,14.285714285714285,0,0,0,-14.285714285714285,0
dan majerle,0,0,0,0,0,0,0,0,0,0,0
jeff withey,0,1,0,0,1,0,0,0,0,0,0
jordan crawford,37,95,38.94736842105263,34,85,40,3,10,30,-10,10.526315789473683
ledell eackles,0,0,0,0,0,0,0,0,0,0,0
quincy acy,37,90,41.11111111111111,36,80,45,1,10,10,-35,11.11111111111111
tyus jones,26,73,35.61643835616438,25,68,36.76470588235294,1,5,20,-16.764705882352942,6.8493150684931505
alec burks,25,76,32.89473684210527,24,72,33.33333333333333,1,4,25,-8.333333333333329,5.263157894736842
bryant stith,0,0,0,0,0,0,0,0,0,0,0
d.j. augustin,95,274,34.67153284671533,83,236,35.16949152542373,12,38,31.57894736842105,-3.590544157002679,13.86861313868613
dennis schroder,100,294,34.01360544217687,95,279,34.05017921146953,5,15,33.33333333333333,-0.7168458781362048,5.1020408163265305
ish smith,28,105,26.666666666666668,28,105,26.666666666666668,0,0,0,-26.666666666666668,0
kemba walker,240,602,39.8671096345515,206,501,41.11776447105788,34,101,33.663366336633665,-7.454398134424217,16.77740863787375
kevin pritchard,0,0,0,0,0,0,0,0,0,0,0
rakeem christmas,0,0,0,0,0,0,0,0,0,0,0
reggie miller,0,0,0,0,0,0,0,0,0,0,0
tyreke evans,42,118,35.59322033898305,36,102,35.294117647058826,6,16,37.5,2.205882352941174,13.559322033898304
zach lavine,120,310,38.70967741935484,108,269,40.14869888475837,12,41,29.268292682926827,-10.88040620183154,13.225806451612904
alexis ajinca,0,4,0,0,4,0,0,0,0,0,0
anthony morrow,41,133,30.82706766917293,40,126,31.746031746031743,1,7,14.285714285714285,-17.46031746031746,5.263157894736842
aron baynes,0,0,0,0,0,0,0,0,0,0,0
devin booker,147,405,36.2962962962963,129,357,36.134453781512605,18,48,37.5,1.3655462184873954,11.851851851851853
joe johnson,106,258,41.08527131782946,97,239,40.58577405857741,9,19,47.368421052631575,6.7826469940541685,7.3643410852713185
josh mcroberts,13,31,41.935483870967744,13,28,46.42857142857143,0,3,0,-46.42857142857143,9.67741935483871
marty conlon,0,0,0,0,0,0,0,0,0,0,0
rex chapman,0,0,0,0,0,0,0,0,0,0,0
robert werdann,0,0,0,0,0,0,0,0,0,0,0
scott haskin,0,0,0,0,0,0,0,0,0,0,0
tyler ulis,21,79,26.582278481012654,21,78,26.923076923076923,0,1,0,-26.923076923076923,1.2658227848101267
vernon maxwell,0,0,0,0,0,0,0,0,0,0,0
anthony mason,0,0,0,0,0,0,0,0,0,0,0
cole aldrich,0,0,0,0,0,0,0,0,0,0,0
detlef schrempf,0,0,0,0,0,0,0,0,0,0,0
tim breaux,0,0,0,0,0,0,0,0,0,0,0
timofey mozgov,0,1,0,0,1,0,0,0,0,0,0
zaza pachulia,0,2,0,0,2,0,0,0,0,0,0
alonzo gee,0,3,0,0,3,0,0,0,0,0,0
anthony bowie,0,0,0,0,0,0,0,0,0,0,0
jameer nelson,106,273,38.82783882783883,98,239,41.00418410041841,8,34,23.52941176470588,-17.474772335712533,12.454212454212454
jordan mcrae,18,51,35.294117647058826,18,49,36.734693877551024,0,2,0,-36.734693877551024,3.9215686274509802
kyrie irving,177,441,40.136054421768705,157,376,41.755319148936174,20,65,30.76923076923077,-10.986088379705404,14.73922902494331
shabazz muhammad,49,145,33.793103448275865,47,136,34.55882352941176,2,9,22.22222222222222,-12.33660130718954,6.206896551724138
stephen curry,324,789,41.06463878326996,262,634,41.32492113564668,62,155,40,-1.324921135646683,19.64512040557668
brooks thompson,0,0,0,0,0,0,0,0,0,0,0
gheorghe muresan,0,0,0,0,0,0,0,0,0,0,0
isaiah thomas,245,646,37.925696594427244,208,533,39.02439024390244,37,113,32.743362831858406,-6.281027412044033,17.492260061919502
jon koncak,0,0,0,0,0,0,0,0,0,0,0
julius randle,17,63,26.984126984126984,17,62,27.419354838709676,0,1,0,-27.419354838709676,1.5873015873015872
justin anderson,58,194,29.896907216494846,50,176,28.40909090909091,8,18,44.44444444444444,16.035353535353533,9.278350515463918
cj miles,169,409,41.32029339853301,146,351,41.5954415954416,23,58,39.6551724137931,-1.940269181648496,14.180929095354522
danuel house,0,0,0,0,0,0,0,0,0,0,0
dwayne schintzius,0,0,0,0,0,0,0,0,0,0,0
jarnell stokes,0,0,0,0,0,0,0,0,0,0,0
kyle singler,7,37,18.91891891891892,7,36,19.444444444444446,0,1,0,-19.444444444444446,2.7027027027027026
nick van exel,0,0,0,0,0,0,0,0,0,0,0
terry davis,0,0,0,0,0,0,0,0,0,0,0
alton lister,0,0,0,0,0,0,0,0,0,0,0
anderson varejao,0,0,0,0,0,0,0,0,0,0,0
andrew declercq,0,0,0,0,0,0,0,0,0,0,0
ben bentil,0,1,0,0,1,0,0,0,0,0,0
mario hezonja,43,144,29.86111111111111,40,132,30.303030303030305,3,12,25,-5.3030303030303045,8.333333333333332
pj tucker,70,196,35.714285714285715,66,183,36.0655737704918,4,13,30.76923076923077,-5.296343001261032,6.63265306122449
brian greene,0,0,0,0,0,0,0,0,0,0,0
dwight powell,21,74,28.37837837837838,21,72,29.166666666666668,0,2,0,-29.166666666666668,2.7027027027027026
george hill,94,233,40.343347639484975,84,210,40,10,23,43.47826086956522,3.4782608695652186,9.871244635193133
jamychal green,55,145,37.93103448275862,51,138,36.95652173913043,4,7,57.14285714285714,20.18633540372671,4.827586206896552
lindsey hunter,0,0,0,0,0,0,0,0,0,0,0
terry dehere,0,0,0,0,0,0,0,0,0,0,0
anthony avent,0,0,0,0,0,0,0,0,0,0,0
anthony peeler,0,0,0,0,0,0,0,0,0,0,0
marco belinelli,102,283,36.042402826855124,90,243,37.03703703703704,12,40,30,-7.037037037037038,14.13427561837456
marshall plumlee,0,0,0,0,0,0,0,0,0,0,0
matt bullard,0,0,0,0,0,0,0,0,0,0,0
sasha vujacic,23,74,31.08108108108108,21,64,32.8125,2,10,20,-12.8125,13.513513513513514
todd day,0,0,0,0,0,0,0,0,0,0,0
brandon knight,45,139,32.37410071942446,43,131,32.82442748091603,2,8,25,-7.824427480916029,5.755395683453238
kentavious caldwell-pope,153,437,35.01144164759725,134,374,35.82887700534759,19,63,30.158730158730158,-5.670146846617435,14.416475972540047
reggie williams,5,11,45.45454545454545,4,10,40,1,1,100,60,9.090909090909092
sergio rodriguez,92,252,36.507936507936506,82,225,36.44444444444444,10,27,37.03703703703704,0.5925925925925952,10.714285714285714
alex poythress,6,19,31.57894736842105,4,15,26.666666666666668,2,4,50,23.333333333333332,21.052631578947366
alonzo mourning,0,0,0,0,0,0,0,0,0,0,0
chuck person,0,0,0,0,0,0,0,0,0,0,0
edy tavares,0,0,0,0,0,0,0,0,0,0,0
kj mcdaniels,20,66,30.303030303030305,20,64,31.25,0,2,0,-31.25,3.0303030303030303
keith jennings,0,0,0,0,0,0,0,0,0,0,0
delon wright,10,30,33.33333333333333,10,29,34.48275862068966,0,1,0,-34.48275862068966,3.3333333333333335
greg foster,0,0,0,0,0,0,0,0,0,0,0
jarell martin,9,25,36,9,25,36,0,0,0,-36,0
kyle lowry,193,468,41.23931623931624,173,418,41.38755980861244,20,50,40,-1.387559808612437,10.683760683760683
lance stephenson,6,20,30,5,19,26.31578947368421,1,1,100,73.6842105263158,5
raul neto,10,31,32.25806451612903,9,29,31.03448275862069,1,2,50,18.96551724137931,6.451612903225806
anfernee hardaway,0,0,0,0,0,0,0,0,0,0,0
chris king,0,0,0,0,0,0,0,0,0,0,0
emmanuel mudiay,56,178,31.46067415730337,48,163,29.447852760736197,8,15,53.333333333333336,23.88548057259714,8.426966292134832
kris dunn,21,73,28.767123287671232,20,71,28.169014084507044,1,2,50,21.830985915492956,2.73972602739726
lou williams,163,446,36.54708520179372,134,384,34.89583333333333,29,62,46.774193548387096,11.878360215053767,13.901345291479823
michael adams,0,0,0,0,0,0,0,0,0,0,0
omer asik,0,0,0,0,0,0,0,0,0,0,0
rick mahorn,0,0,0,0,0,0,0,0,0,0,0
aaron mckie,0,0,0,0,0,0,0,0,0,0,0
chris webber,0,0,0,0,0,0,0,0,0,0,0
dante exum,44,149,29.53020134228188,43,143,30.069930069930066,1,6,16.666666666666664,-13.403263403263402,4.026845637583892
jamal murray,115,344,33.43023255813954,100,297,33.670033670033675,15,47,31.914893617021278,-1.755140053012397,13.662790697674417
jimmy butler,91,248,36.693548387096776,87,236,36.86440677966102,4,12,33.33333333333333,-3.5310734463276887,4.838709677419355
andre iguodala,64,177,36.15819209039548,60,165,36.36363636363637,4,12,33.33333333333333,-3.0303030303030383,6.779661016949152
darrell arthur,53,117,45.2991452991453,45,105,42.857142857142854,8,12,66.66666666666666,23.809523809523803,10.256410256410255
derrick jones jr.,3,11,27.27272727272727,3,11,27.27272727272727,0,0,0,-27.27272727272727,0
iman shumpert,94,261,36.015325670498086,83,237,35.0210970464135,11,24,45.83333333333333,10.812236286919827,9.195402298850574
joe young,5,23,21.73913043478261,5,21,23.809523809523807,0,2,0,-23.809523809523807,8.695652173913043
kenneth faried,0,6,0,0,6,0,0,0,0,0,0
luc mbah a moute,43,110,39.09090909090909,42,107,39.25233644859813,1,3,33.33333333333333,-5.9190031152648,2.727272727272727
udonis haslem,0,3,0,0,3,0,0,0,0,0,0
alex len,3,12,25,3,12,25,0,0,0,-25,0
chris gatling,0,0,0,0,0,0,0,0,0,0,0
chucky brown,0,0,0,0,0,0,0,0,0,0,0
derrick favors,3,10,30,3,10,30,0,0,0,-30,0
eric gordon,246,661,37.21633888048411,201,545,36.88073394495413,45,116,38.793103448275865,1.9123695033217345,17.549167927382754
john starks,0,0,0,0,0,0,0,0,0,0,0
kevin edwards,0,0,0,0,0,0,0,0,0,0,0
kyle o'quinn,2,17,11.76470588235294,2,17,11.76470588235294,0,0,0,-11.76470588235294,0
roy hibbert,0,0,0,0,0,0,0,0,0,0,0
rudy gobert,0,1,0,0,1,0,0,0,0,0,0
gary payton,1,9,11.11111111111111,1,9,11.11111111111111,0,0,0,-11.11111111111111,0
jabari parker,65,178,36.51685393258427,58,162,35.80246913580247,7,16,43.75,7.947530864197532,8.98876404494382
jake layman,13,51,25.49019607843137,11,47,23.404255319148938,2,4,50,26.595744680851062,7.8431372549019605
jodie meeks,56,137,40.87591240875913,45,113,39.823008849557525,11,24,45.83333333333333,6.010324483775804,17.51824817518248
okaro white,12,34,35.294117647058826,12,34,35.294117647058826,0,0,0,-35.294117647058826,0
adreian payne,3,15,20,3,15,20,0,0,0,-20,0
andrew wiggins,103,289,35.6401384083045,97,276,35.14492753623188,6,13,46.15384615384615,11.00891861761427,4.498269896193772
gary neal,0,2,0,0,2,0,0,0,0,0,0
j.r. reid,0,0,0,0,0,0,0,0,0,0,0
jarrett jack,0,1,0,0,1,0,0,0,0,0,0
nicolas brussino,29,95,30.526315789473685,26,87,29.88505747126437,3,8,37.5,7.614942528735629,8.421052631578947
richard jefferson,62,186,33.33333333333333,55,172,31.976744186046513,7,14,50,18.023255813953487,7.526881720430108
tarik black,1,2,50,1,2,50,0,0,0,-50,0
yogi ferrell,68,176,38.63636363636363,63,159,39.62264150943396,5,17,29.411764705882355,-10.210876803551606,9.659090909090908
bobby hurley,0,0,0,0,0,0,0,0,0,0,0
derek harper,0,0,0,0,0,0,0,0,0,0,0
garrett temple,82,220,37.27272727272727,80,212,37.735849056603776,2,8,25,-12.735849056603776,3.6363636363636362
greg minor,0,0,0,0,0,0,0,0,0,0,0
hakeem olajuwon,0,0,0,0,0,0,0,0,0,0,0
rick fox,0,0,0,0,0,0,0,0,0,0,0
darrin hancock,0,0,0,0,0,0,0,0,0,0,0
justin hamilton,55,180,30.555555555555557,52,168,30.952380952380953,3,12,25,-5.9523809523809526,6.666666666666667
leandro barbosa,35,98,35.714285714285715,33,90,36.666666666666664,2,8,25,-11.666666666666664,8.16326530612245
marreese speights,103,277,37.18411552346571,93,243,38.2716049382716,10,34,29.411764705882355,-8.859840232389246,12.274368231046932
steve novak,1,6,16.666666666666664,1,6,16.666666666666664,0,0,0,-16.666666666666664,0
chasson randle,16,47,34.04255319148936,14,43,32.55813953488372,2,4,50,17.441860465116278,8.51063829787234
deandre liggins,17,46,36.95652173913043,17,44,38.63636363636363,0,2,0,-38.63636363636363,4.3478260869565215
jonathan gibson,15,45,33.33333333333333,13,40,32.5,2,5,40,7.5,11.11111111111111
lance thomas,38,85,44.70588235294118,36,81,44.44444444444444,2,4,50,5.555555555555557,4.705882352941177
david wood,0,0,0,0,0,0,0,0,0,0,0
raymond felton,46,144,31.944444444444443,43,137,31.386861313868614,3,7,42.857142857142854,11.47028154327424,4.861111111111112
deandre jordan,0,2,0,0,2,0,0,0,0,0,0
dwayne morton,0,0,0,0,0,0,0,0,0,0,0
goran dragic,117,289,40.484429065743946,108,271,39.85239852398524,9,18,50,10.147601476014763,6.228373702422145
john crotty,0,0,0,0,0,0,0,0,0,0,0
jud buechler,0,0,0,0,0,0,0,0,0,0,0
lee mayberry,0,0,0,0,0,0,0,0,0,0,0
marques bragg,0,0,0,0,0,0,0,0,0,0,0
mirza teletovic,104,305,34.0983606557377,88,257,34.24124513618677,16,48,33.33333333333333,-0.907911802853441,15.737704918032788
davis bertans,69,173,39.884393063583815,58,148,39.189189189189186,11,25,44,4.810810810810814,14.450867052023122
georges niang,1,12,8.333333333333332,1,12,8.333333333333332,0,0,0,-8.333333333333332,0
joe wolf,0,0,0,0,0,0,0,0,0,0,0
nick young,170,421,40.38004750593824,137,339,40.41297935103245,33,82,40.243902439024396,-0.16907691200805175,19.47743467933492
tim quarterman,5,13,38.46153846153847,5,13,38.46153846153847,0,0,0,-38.46153846153847,0
craig ehlo,0,0,0,0,0,0,0,0,0,0,0
justise winslow,7,35,20,6,34,17.647058823529413,1,1,100,82.35294117647058,2.857142857142857
luol deng,51,165,30.909090909090907,48,152,31.57894736842105,3,13,23.076923076923077,-8.502024291497975,7.878787878787878
wesley person,0,0,0,0,0,0,0,0,0,0,0
armen gilliam,0,0,0,0,0,0,0,0,0,0,0
justin holiday,97,273,35.53113553113553,91,248,36.693548387096776,6,25,24,-12.693548387096776,9.157509157509157
bojan bogdanovic,144,392,36.734693877551024,129,335,38.50746268656716,15,57,26.31578947368421,-12.19167321288295,14.540816326530612
brandon jennings,79,252,31.349206349206348,67,219,30.59360730593607,12,33,36.36363636363637,5.770029057700295,13.095238095238097
chandler parsons,25,93,26.881720430107524,24,88,27.27272727272727,1,5,20,-7.27272727272727,5.376344086021505
gerald henderson,61,173,35.26011560693642,59,162,36.41975308641975,2,11,18.181818181818183,-18.23793490460157,6.358381502890173
ken norman,0,0,0,0,0,0,0,0,0,0,0
micheal williams,0,0,0,0,0,0,0,0,0,0,0
mookie blaylock,0,0,0,0,0,0,0,0,0,0,0
tim legler,0,0,0,0,0,0,0,0,0,0,0
alex abrines,94,247,38.05668016194332,76,214,35.51401869158878,18,33,54.54545454545454,19.03143585386576,13.360323886639677
ben mclemore,65,170,38.23529411764706,53,148,35.810810810810814,12,22,54.54545454545454,18.734643734643726,12.941176470588237
chris childs,0,0,0,0,0,0,0,0,0,0,0
maurice ndour,1,7,14.285714285714285,1,7,14.285714285714285,0,0,0,-14.285714285714285,0
ryan kelly,4,10,40,3,9,33.33333333333333,1,1,100,66.66666666666667,10
al horford,86,242,35.53719008264463,81,229,35.37117903930131,5,13,38.46153846153847,3.0903594222371567,5.371900826446281
andrew harrison,43,156,27.564102564102566,43,153,28.104575163398692,0,3,0,-28.104575163398692,1.9230769230769231
bob sura,0,0,0,0,0,0,0,0,0,0,0
c.j. watson,32,105,30.476190476190478,31,96,32.29166666666667,1,9,11.11111111111111,-21.18055555555556,8.571428571428571
demarcus cousins,131,363,36.08815426997245,116,321,36.13707165109034,15,42,35.714285714285715,-0.4227859368046225,11.570247933884298
stacey augmon,0,0,0,0,0,0,0,0,0,0,0
tj warren,26,98,26.53061224489796,26,97,26.804123711340207,0,1,0,-26.804123711340207,1.0204081632653061
clar. weatherspoon,0,0,0,0,0,0,0,0,0,0,0
eddie jones,0,0,0,0,0,0,0,0,0,0,0
elijah millsap,0,2,0,0,2,0,0,0,0,0,0
kevin love,145,389,37.275064267352185,119,326,36.50306748466258,26,63,41.269841269841265,4.766773785178685,16.195372750642672
michael kidd-gilchrist,1,9,11.11111111111111,1,9,11.11111111111111,0,0,0,-11.11111111111111,0
olden polynice,0,0,0,0,0,0,0,0,0,0,0
rj hunter,0,1,0,0,1,0,0,0,0,0,0
terrence ross,142,391,36.31713554987212,124,335,37.014925373134325,18,56,32.142857142857146,-4.872068230277179,14.322250639386189
channing frye,137,335,40.8955223880597,124,281,44.128113879003564,13,54,24.074074074074073,-20.05403980492949,16.119402985074625
marcus georges-hunt,1,2,50,1,2,50,0,0,0,-50,0
michael gbinije,0,4,0,0,4,0,0,0,0,0,0
rodney mcgruder,73,220,33.18181818181819,69,206,33.49514563106796,4,14,28.57142857142857,-4.923717059639394,6.363636363636363
ronnie price,3,17,17.647058823529413,3,17,17.647058823529413,0,0,0,-17.647058823529413,0
serge ibaka,124,317,39.11671924290221,114,295,38.64406779661017,10,22,45.45454545454545,6.81047765793528,6.940063091482649
horace grant,0,0,0,0,0,0,0,0,0,0,0
jae crowder,157,394,39.847715736040605,140,357,39.21568627450981,17,37,45.94594594594595,6.730259671436144,9.390862944162437
lavoy allen,0,1,0,0,1,0,0,0,0,0,0
nicolas laprovittola,10,27,37.03703703703704,10,26,38.46153846153847,0,1,0,-38.46153846153847,3.7037037037037033
steve scheffler,0,0,0,0,0,0,0,0,0,0,0
dewayne dedmon,0,0,0,0,0,0,0,0,0,0,0
kawhi leonard,147,387,37.98449612403101,130,342,38.01169590643275,17,45,37.77777777777778,-0.2339181286549703,11.627906976744185
khalid reeves,0,0,0,0,0,0,0,0,0,0,0
nate mcmillan,0,0,0,0,0,0,0,0,0,0,0
paul zipser,33,99,33.33333333333333,31,89,34.831460674157306,2,10,20,-14.831460674157306,10.1010101010101
sharone wright,0,0,0,0,0,0,0,0,0,0,0
willie burton,0,0,0,0,0,0,0,0,0,0,0
dejounte murray,9,23,39.130434782608695,8,21,38.095238095238095,1,2,50,11.904761904761905,8.695652173913043
klay thompson,268,647,41.42194744976816,218,535,40.74766355140187,50,112,44.642857142857146,3.895193591455275,17.31066460587326
noah vonleh,7,20,35,6,19,31.57894736842105,1,1,100,68.42105263157895,5
rod strickland,0,0,0,0,0,0,0,0,0,0,0
sarunas marciulionis,0,0,0,0,0,0,0,0,0,0,0
sheldon mcclellan,7,30,23.333333333333332,7,28,25,0,2,0,-25,6.666666666666667
terry mills,0,0,0,0,0,0,0,0,0,0,0
devin harris,58,177,32.7683615819209,54,162,33.33333333333333,4,15,26.666666666666668,-6.666666666666661,8.47457627118644
malcolm delaney,26,110,23.636363636363637,25,108,23.14814814814815,1,2,50,26.85185185185185,1.8181818181818181
paul pierce,15,43,34.883720930232556,14,37,37.83783783783784,1,6,16.666666666666664,-21.171171171171174,13.953488372093023
sasha danilovic,0,0,0,0,0,0,0,0,0,0,0
troy daniels,138,355,38.87323943661972,119,293,40.61433447098976,19,62,30.64516129032258,-9.96917318066718,17.464788732394364
tyler ennis,27,70,38.57142857142858,24,60,40,3,10,30,-10,14.285714285714285
amir johnson,27,66,40.909090909090914,25,63,39.682539682539684,2,3,66.66666666666666,26.984126984126974,4.545454545454546
daniel ochefu,0,0,0,0,0,0,0,0,0,0,0
dontonio wingfield,0,0,0,0,0,0,0,0,0,0,0
shaquille o'neal,0,0,0,0,0,0,0,0,0,0,0
will barton,87,235,37.02127659574468,77,209,36.84210526315789,10,26,38.46153846153847,1.6194331983805768,11.063829787234042
brice johnson,0,0,0,0,0,0,0,0,0,0,0
dario saric,106,341,31.085043988269796,102,319,31.974921630094045,4,22,18.181818181818183,-13.793103448275861,6.451612903225806
john wall,89,272,32.720588235294116,77,238,32.35294117647059,12,34,35.294117647058826,2.941176470588239,12.5
keith askins,0,0,0,0,0,0,0,0,0,0,0
mario elie,0,0,0,0,0,0,0,0,0,0,0
robert horry,0,0,0,0,0,0,0,0,0,0,0
shabazz napier,34,92,36.95652173913043,30,85,35.294117647058826,4,7,57.14285714285714,21.848739495798313,7.608695652173914
aj hammons,5,10,50,5,10,50,0,0,0,-50,0
cheick diallo,0,0,0,0,0,0,0,0,0,0,0
derrick mckey,0,0,0,0,0,0,0,0,0,0,0
malcolm brogdon,78,193,40.41450777202073,73,182,40.10989010989011,5,11,45.45454545454545,5.344655344655344,5.699481865284974
mike peplowski,0,0,0,0,0,0,0,0,0,0,0
mike scott,4,27,14.814814814814813,4,27,14.814814814814813,0,0,0,-14.814814814814813,0
montrezl harrell,1,7,14.285714285714285,1,7,14.285714285714285,0,0,0,-14.285714285714285,0
norman powell,56,173,32.369942196531795,52,162,32.098765432098766,4,11,36.36363636363637,4.264870931537601,6.358381502890173
aaron gordon,77,267,28.83895131086142,77,255,30.19607843137255,0,12,0,-30.19607843137255,4.49438202247191
al jefferson,0,1,0,0,1,0,0,0,0,0,0
arinze onuaku,0,0,0,0,0,0,0,0,0,0,0
demetrius jackson,1,1,100,1,1,100,0,0,0,-100,0
evan fournier,128,360,35.55555555555556,115,313,36.74121405750799,13,47,27.659574468085108,-9.081639589422881,13.055555555555557
harold miner,0,0,0,0,0,0,0,0,0,0,0
james johnson,87,256,33.984375,83,245,33.87755102040816,4,11,36.36363636363637,2.486085343228204,4.296875
kevin duckworth,0,0,0,0,0,0,0,0,0,0,0
malik beasley,9,28,32.142857142857146,7,22,31.818181818181817,2,6,33.33333333333333,1.515151515151512,21.428571428571427
skal labissiere,3,8,37.5,3,8,37.5,0,0,0,-37.5,0
antonio harvey,0,0,0,0,0,0,0,0,0,0,0
ashraf amaya,0,0,0,0,0,0,0,0,0,0,0
cedric ceballos,0,0,0,0,0,0,0,0,0,0,0
derrick williams,30,97,30.927835051546392,30,90,33.33333333333333,0,7,0,-33.33333333333333,7.216494845360824
jamal crawford,116,322,36.024844720496894,107,284,37.67605633802817,9,38,23.684210526315788,-13.99184581171238,11.801242236024844
malachi richardson,8,28,28.57142857142857,8,25,32,0,3,0,-32,10.714285714285714
nicolas batum,135,405,33.33333333333333,117,357,32.773109243697476,18,48,37.5,4.726890756302524,11.851851851851853
toni kukoc,0,0,0,0,0,0,0,0,0,0,0
isaiah taylor,0,2,0,0,2,0,0,0,0,0,0
trevor ruffin,0,0,0,0,0,0,0,0,0,0,0
doug overton,0,0,0,0,0,0,0,0,0,0,0
gordon hayward,149,374,39.839572192513366,142,338,42.01183431952663,7,36,19.444444444444446,-22.56738987508218,9.62566844919786
tristan thompson,0,3,0,0,3,0,0,0,0,0,0
antoine carr,0,0,0,0,0,0,0,0,0,0,0
cj mccollum,185,439,42.14123006833713,156,387,40.310077519379846,29,52,55.769230769230774,15.459153249850928,11.845102505694761
dahntay jones,0,2,0,0,2,0,0,0,0,0,0
elliot perry,0,0,0,0,0,0,0,0,0,0,0
eric mobley,0,0,0,0,0,0,0,0,0,0,0
nikola vucevic,23,75,30.666666666666664,20,70,28.57142857142857,3,5,60,31.42857142857143,6.666666666666667
paul george,195,495,39.39393939393939,173,427,40.5152224824356,22,68,32.35294117647059,-8.16228130596501,13.737373737373737
al-farouq aminu,70,212,33.0188679245283,66,203,32.51231527093596,4,9,44.44444444444444,11.932129173508486,4.245283018867925
andre roberson,45,184,24.456521739130434,44,178,24.719101123595504,1,6,16.666666666666664,-8.05243445692884,3.260869565217391
bruno caboclo,2,6,33.33333333333333,2,6,33.33333333333333,0,0,0,-33.33333333333333,0
george lynch,0,0,0,0,0,0,0,0,0,0,0
jason smith,37,78,47.43589743589743,32,67,47.76119402985074,5,11,45.45454545454545,-2.3066485753052888,14.102564102564102
tom hammonds,0,0,0,0,0,0,0,0,0,0,0
